-01 -01 -01 -01 -01 -01 -01 -01 -01 -01 -01 -01 -01 -01 -01 -01 -01
-01 000 001 002 003 004 005 006 -01 007 008 009 010 011 012 013 -01
-01 014 -01 015 -01 -01 -01 016 -01 017 -01 -01 -01 018 -01 019 -01
-01 020 021 022 023 024 025 026 027 028 029 030 031 032 033 034 -01
-01 035 -01 036 -01 037 -01 -01 -01 -01 -01 038 -01 039 -01 040 -01
-01 041 042 043 -01 044 045 046 -01 047 048 049 -01 050 051 052 -01
-01 -01 -01 053 -01 -01 -01 054 -01 055 -01 -01 -01 056 -01 -01 -01
-01 -01 -01 057 -01 058 059 060 061 062 063 064 -01 065 -01 -01 -01
-01 -01 -01 066 -01 067 -01 -01 068 -01 -01 069 -01 070 -01 -01 -01
071 072 073 074 075 076 -01 077 078 079 -01 080 081 082 083 084 085
-01 -01 -01 086 -01 087 -01 -01 -01 -01 -01 088 -01 089 -01 -01 -01
-01 -01 -01 090 -01 091 092 093 094 095 096 097 -01 098 -01 -01 -01
-01 -01 -01 099 -01 100 -01 -01 -01 -01 -01 101 -01 102 -01 -01 -01
-01 103 104 105 106 107 108 109 -01 110 111 112 113 114 115 116 -01
-01 117 -01 -01 118 -01 -01 119 -01 120 -01 -01 121 -01 -01 122 -01
-01 123 124 -01 125 126 127 128 129 130 131 132 134 -01 135 136 -01
-01 -01 137 -01 138 -01 139 -01 -01 -01 140 -01 141 -01 142 -01 -01
-01 143 144 145 146 -01 147 148 -01 149 150 -01 151 152 153 154 -01
-01 155 -01 -01 -01 -01 -01 156 -01 157 -01 -01 -01 -01 -01 158 -01
-01 159 160 161 162 163 164 165 166 167 168 169 170 171 172 173 -01
-01 -01 -01 -01 -01 -01 -01 -01 -01 -01 -01 -01 -01 -01 -01 -01 -01
